111111111111111
1P000C0001000E1
111111111111111